┼┼┼┼┼┼┼┼┼┼┼┼┼┼┼┼┼╆┷╅╆┷┷┷┷┷┷┷┷┷╅┼┼┼┼┼┼┼┼┼┼┼┼┼┼┼┼┼
┼┼┼┼┼┼┼┼┼┼┼┼┼┼╆┷┷┛ ┠┨  $      ┗┷┷╅┼┼┼┼┼┼┼┼┼┼┼┼┼┼
┼┼┼┼┼┼┼┼┼┼┼┼╆┷┛    ┠╄┯┯┯┯┯┯┯┓    ┗┷╅┼┼┼┼┼┼┼┼┼┼┼┼
┼┼┼┼┼┼┼┼┼┼╆┷┛   ┏┯┯╃┼┼┼┼┼┼┼┼╄┯┯┓   ┗┷╅┼┼┼┼┼┼┼┼┼┼
┼┼┼┼┼┼┼┼┼╆┛   ┏┯╃╆┷┷┷┷┷┷┷┷┷┷┷┷╅╄┯┓   ┗╅┼┼┼┼┼┼┼┼┼
┼┼┼┼┼┼┼┼╆┛  ┏┯╃┼┼┨            ┠┼┼╄┯┓  ┗╅┼┼┼┼┼┼┼┼
┼┼┼┼┼┼┼╆┛  ┏╃┼┼┼┼┨ ┏┯┯┯┯┯┓ ┏┓ ┠┼┼┼┼╄┓  ┗╅┼┼┼┼┼┼┼
┼┼┼┼┼┼╆┛   ┗┷┷┷╅┼┨ ┗┷┷┷┷╅┨ ┠┨ ┗┷┷┷┷┷┛   ┗╅┼┼┼┼┼┼
┼┼┼┼┼╆┛        ┠┼┨      ┠┨ ┠┨            ┠┼┼┼┼┼┼
┼┼┼┼╆┛  ┏┯┯┯┯┓ ┠┼╄┯┓ ┏┓ ┠┨ ┠┨ ┏┯┯┯┯┯┯┯┯┯┯╃┼┼┼┼┼┼
┼┼┼╆┛  ┏╃┼╆┷┷┛ ┗┷┷┷┛ ┗┛ ┗┛ ┗┛ ┗┷┷┷╅╆┷┷┷┷┷┷┷┷╅┼┼┼
┼┼┼┨  ┏╃┼┼┨                       ┠┨        ┠┼┼┼
┼┼╆┛ ┏╃┼┼┼╄┯┯┯┯┯┯┯┯┯┯┯┯┯┯┯┯┯┯┯┯┯┯┯╃┨ ┏┯┯┯┯┓ ┗╅┼┼
┼┼┨  ┠┼╆┷┷┷┷┷┷┷╅╆┷┷┷┷┷┷┷┷┷┷┷┷┷┷┷┷┷┷┛ ┗┷┷┷╅┨  ┠┼┼
┼╆┛ ┏╃┼┨       ┠┨                        ┠╄┓ ┗╅┼
┼┨  ┠┼┼┨ ┏┯┯┯┓ ┠╄┯┯┯┯┯┯┯┓ ┏┯┯┯┯┯┓ ┏┓ ┏┯┓ ┠┼┨  ┠┼
┼┨ ┏╃┼┼┨ ┠╆┷╅┨ ┠╆┷┷┷┷┷┷╅┨ ┗┷┷┷┷╅┨ ┠┨ ┗┷┛ ┠┼╄┓ ┠┼
╆┛ ┠╆┷╅┨ ┠┨ ┠┨ ┠┨      ┠┨      ┠┨ ┠┨     ┠┼┼┨ ┗╅
┨  ┠┨ ┠┨ ┠┨ ┠┨ ┠┨ ┏┯┯┓ ┠╄┯┯┯┯┓ ┠┨ ┠┨ ┏┯┯┯╃┼┼┨  ┠
┨ ┏╃┨ ┠┨ ┗┛ ┠┨ ┠┨ ┠╆┷┛ ┗┷┷┷┷╅┨ ┠┨ ┠┨ ┠╆┷┷┷┷╅╄┓ ┠
┨ ┗┷┛ ┠┨    ┠┨ ┠┨ ┠┨        ┠┨ ┠┨ ┠┨ ┠┨    ┗┷┛ ┠
┨     ┠┨ ┏┓ ┠┨ ┠┨ ┠┨ ┏┯┯┯┯┓ ┠┨ ┗┛ ┗┛ ┠┨ ┏┓     ┠
┨ ┏┓ ┏╃┨ ┠┨ ┠┨ ┠┨ ┠┨ ┠╆┷╅┼┨ ┠┨       ┠┨ ┠┨ ┏┯┓ ┠
┨ ┠┨ ┠┼┨ ┠┨ ┠┨ ┠┨ ┠┨ ┠┨*┗┷┛ ┠┨ ┏┯┯┯┯┯╃┨ ┠┨ ┠┼╄┯╃
┨ ┠┨ ┠┼┨ ┠┨ ┠┨ ┠┨ ┠┨ ┠┨     ┠┨ ┠╆┷┷┷┷╅┨ ┠┨ ┠┼╆┷╅
┨ ┗┛ ┗╅┨ ┗┛ ┠┨ ┠┨ ┠┨ ┠╄┯┯┯┓ ┠┨ ┠┨    ┠┨ ┠┨ ┗┷┛ ┠
┨     ┠┨    ┠┨ ┠┨ ┗┛ ┠┼╆┷┷┛ ┠┨ ┠┨ ┏┓ ┠┨ ┗┛     ┠
┨ ┏┯┓ ┠┨ ┏┓ ┠┨ ┠┨    ┠┼┨    ┠┨ ┗┛ ┠┨ ┠┨    ┏┯┓ ┠
┨ ┗╅┨ ┠┨ ┠┨ ┠┨ ┠┨ ┏┓ ┠┼┨ ┏┯┯╃┨    ┠┨ ┠╄┯┯┯┯╃╆┛ ┠
┨  ┠┨ ┠┨ ┠┨ ┠┨ ┠┨ ┠┨ ┗┷┛ ┠╆┷┷┛ ┏┓ ┠┨ ┗┷┷╅┼┼┼┨  ┠
╄┓ ┠╄┯╃┨ ┠┨ ┠┨ ┠┨ ┠┨     ┠┨    ┠┨ ┗┛    ┠┼┼┼┨ ┏╃
┼┨ ┗┷┷┷┛ ┠╄┯╃┨ ┠┨ ┠╄┯┯┯┯┯╃┨ ┏┯┯╃┨    ┏┓ ┠┼┼╆┛ ┠┼
┼┨       ┠╆┷┷┛ ┠┨ ┗┷┷┷┷┷┷┷┛ ┗┷┷┷┛ ┏┓ ┗┛ ┠┼┼┨  ┠┼
┼╄┯┯┯┯┯┯┯╃┨    ┠┨                 ┠┨    ┠┼╆┛ ┏╃┼
┼┼┼┼┼┼┼┼┼┼┨ ┏┯┯╃╄┯┯┯┯┯┯┯┯┯┯┯┓ ┏┯┯┯╃┨ ┏┯┯╃┼┨  ┠┼┼
┼┼┼╆┷┷┷┷┷┷┛ ┠╆┷┷┷┷┷┷┷┷┷┷┷┷┷╅┨ ┗┷┷┷┷┛ ┠┼┼┼╆┛ ┏╃┼┼
┼┼┼┨        ┠┨             ┠┨        ┠┼┼╆┛  ┠┼┼┼
┼┼┼╄┓   ┏┯┯┯╃┨ ┏┯┯┯┯┯┯┯┯┯┓ ┠╄┯┯┯┯┯┯┯┯╃┼╆┛  ┏╃┼┼┼
┼┼┼┼╄┓  ┗┷┷┷┷┛ ┗┷┷┷┷┷┷┷┷┷┛ ┗┷┷┷┷┷┷┷┷┷┷┷┛  ┏╃┼┼┼┼
┼┼┼┼┼╄┓                                  ┏╃┼┼┼┼┼
┼┼┼┼┼┼╄┓   ┏┯┯┯┯┯┓ ┏┯┯┯┯┯┯┯┯┓ ┏┯┯┯┯┯┓   ┏╃┼┼┼┼┼┼
┼┼┼┼┼┼┼╄┓  ┗╅┼┼┼┼┨ ┗┷┷┷┷┷┷┷┷┛ ┠┼┼┼┼╆┛  ┏╃┼┼┼┼┼┼┼
┼┼┼┼┼┼┼┼╄┓  ┗┷╅┼┼┨            ┠┼┼╆┷┛  ┏╃┼┼┼┼┼┼┼┼
┼┼┼┼┼┼┼┼┼╄┓   ┗┷╅┨ ┏┯┯┯┯┯┯┯┯┓ ┠╆┷┛   ┏╃┼┼┼┼┼┼┼┼┼
┼┼┼┼┼┼┼┼┼┼╄┯┓   ┗┛ ┠┼┼┼┼┼┼┼┼┨ ┗┛   ┏┯╃┼┼┼┼┼┼┼┼┼┼
┼┼┼┼┼┼┼┼┼┼┼┼╄┯┓    ┗┷┷┷┷┷┷┷┷┛    ┏┯╃┼┼┼┼┼┼┼┼┼┼┼┼
┼┼┼┼┼┼┼┼┼┼┼┼┼┼╄┯┯┓            ┏┯┯╃┼┼┼┼┼┼┼┼┼┼┼┼┼┼
┼┼┼┼┼┼┼┼┼┼┼┼┼┼┼┼┼╄┯┯┯┯┯┯┯┯┯┯┯┯╃┼┼┼┼┼┼┼┼┼┼┼┼┼┼┼┼┼
